1111111111111111111111111111111111111111
1020202020202020202020202020202020202021
1222222222222222222222222222222222222221
1021111021122111111111111112211021111021
1221111221102020202110202020211221111221
1021102021122222222112222222211020211021
1221122221111111102110211111111222211221
1021102111111111122112211111111110211021
1221122111102020202020202020211112211221
1021102021122222222222222222211020211021
1221122221102111112222111110211222211221
1021111021122122222222222212211021111021
1221111221102122222222222210211221111221
1020202021122111111111111112211020202021
1222222221102020202110202020211222222221
1021111020222222222112222222202021111021
1221111222202111102110211110222221111221
1020202021122111122112211112211020202021
1222222221102110202020202112211222222221
1021111021122112222222222110211021111021
1221111221102110211111102112211221111221
1021102021122112211111122110211020211021
1221122221122222222222222222211222211221
1111111111111111111111111111111111111111
